cpeed = cstewart
diaspeed = diatom
duperspeed = dupree
elspeed = elward
hotspeed = hothead
huntspeed = huntmusky
kaospeed = kaos1
lightspeed = pentemarco
mayspeed = mayfield
miamispeed = namcop
neverspeed = never_win
ridispeed = ridiculoso
spartica = partica
speed_brf = brf
speed_c = cicerolove
speed_cary = caryf300
speed_dw = dweebo
speed_rath = ilurath
speed_v = vitals
speedb = mrbing
speedbump = meister
speedburn = rburn
speeddork = whasenpl
speedford = fordbc
speedfreak = pontus
speedgem = emerald
speedjay = jayhawklov
speedk = kathm5
speedkroy = mrkroy
speedluvn = luvnthots
speedmitri = dmitriking
speedmm = mmammel
speednrob = robsmith
speedracer = boban
speedrock = rockman
speedscale = spdragon
speedsmack = smackdown
speedsnut = snut
speedspark = sparky
speedtee = teefo
speedum = randig
speedup = arneblom
speedup2ng = up2ng
speedvan = vanluu
speedviral = viral
speedwill = william_b
speedyaf = afortune
speedyb = byron
speedybug = littlebug
speedydave = dcholliday
speedydru = andru
speedyese = esmerelda
speedyjoek = joeking
speedylion = mufasa
superspeed = superman
spdymaven = maven
sp_hardy = jeff_hardy
swatsu = watsu
fast_blast = chong
faster3 = richardiii
fastfinger = fingeroff
fastgary = progambler
fastjack = jacks
fastkurupt = kurupt
fastnwise = samwise
fastpipe = oldhippie
qwik_rico = rico_007
qwikmike = mike321
quickchez = thechez
quickmick = mickeyss
quickquack = marlaquack
etnepdeeps = etnep
stoooopid = kmbailey